#SCROLLTEXT#

#R#

#G#

#B#

#X#

#Y#

#SCROLLSPEED_UP#

#SCROLLSPEED_DOWN#

#SCROLLSPEED_LEFT#

#SCROLLSPEED_RIGHT#

#END#
